-########
##      #
#   .   #
#   $   #
# .$@$. #
####$   #
---#.   #
---#   ##
---#####