-## #####
## ## . #
# ## $. #
-## $   #
## $@ ###
# $  ##
#.. ## ##
#   # ##
##### #