--####
###  ####
#   @   ##
# #. .#.###
# $$$ $$$ #
###.#.#.# #
-##       #
--####  ###
-----####