--###########
-##    #    ##
### $ $#$ $ ###
# #$ $ # $ $# #
# $  ..#..  $ #
#  $...#...$  #
# $ .. * .. $ #
###### @ ######
# $ ..   .. $ #
#  $...#...$  #
# $  ..#..  $ #
# #$ $ # $ $# #
### $ $#$ $ ###
-##    #    ##
--###########